R 8888800 88888600
NO ./textures/chaton.xpm
SO ./textures/mur1.xpm
EA ./textures/mur2.xpm
WE ./textures/mur3.xpm
S ./textures/sprite_chaton.xpm

F 0,255,153

C 0,255,255


11111111
100000000000001
1000001111000001
1000001221000001
1000001111000001
10N0000000001
11111111