R 800 600
NO ./textures/chaton.xpm
SO ./textures/mur1.xpm
EA ./textures/mur2.xpm
WE ./textures/mur3.xpm
S ./textures/sprite_chaton.xpm

F 0,255,153

C 0,255,255


1111111111111111111111111111111
1111111111111111011101010010001
1122000211211111111100000010001
12100000000001   000000001100000010001
12000002100211111111101010000001
11222N211101010111110111
120021111111111
111121110101 101111010001
11111111 1110111 111111111111

