
NO ./textures/chaton2.xpm
SO ./textures/chaton2.xpm
WE ./textures/chaton2.xpm
EA ./textures/chaton2.xpm
R 800 600
S ./textures/sprite_chaton.xpm

F 220,255,0
C 225,255,0

1111111111111111111111111
1000000000110000000000001
1011000001110000002000001
1001000000000000000000001
111111111011000001110000  


000000001
100000000011000001111111111111111
11110111111111011100000010001
1111111111111111011101010010001
1102200011011111111100000010001
1010202000001   000000001100000010001
120000100011111111101010000001
110020211101010111110111
10N001111111111
111121110101 101111010001
11111111 1110111 111111111111