R 800 600
NO ./textures/chaton2.xpm
SO ./textures/chaton2.xpm
EA ./textures/chaton2.xpm
WE ./textures/chaton2.xpm
S ./textures/sprite_chaton.xpm

F 0,255,153

C 0,255,255

111111111111111111111111
11110111111111011100000010001
1111111111111111011101010010001
1102200011011111111100000010001
1010202000001   000000001100000010001
120000100011111111101010000001
11002N211101010111110111
100001111111111
111121110101 101111010001
11111111 1110111 111111111111

