R 800 600
NO ./textures/chaton.xpm
SO ./textures/mur1.xpm
EA ./textures/mur2.xpm
WE ./textures/mur3.xpm
S ./textures/sprite_chaton.xpm

F 0,255,153

C 0,255,255


111111111111111
100020000000001
1000001111000001
1002001001000001
1000001111000001
10N000000001111
1111111111111